sku_manufacturer	true
manufacturer	true
ean	true
title	true
description	true
product_price_vat_inc	true
shipping_price_vat_inc	true
quantity	true
brand	true
merchant_category	true
product_url	true
image_1	true
image_2	false
image_3	false
image_4	false
image_5	false
retail_price_vat_inc	false
product_vat_rate	false
shipping_vat_rate	false
manufacturer_pdf	false
ParentSKU	false
parent_title	false
Cross_Sell_SKU	false
ManufacturerWarrantyTime	false
carrier	true
shipping_time	true
use_grid	true
carrier_grid_1	false
shipping_time_carrier_grid_1	false
DisplayWeight	false
carrier_grid_2	false
shipping_time_carrier_grid_2	false
carrier_grid_3	false
shipping_time_carrier_grid_3	false
carrier_grid_4	false
shipping_time_carrier_grid_4	false
free_return	false
min_quantity	false
increment	false
sales	false
eco_participation	false
Price_per_m2_vat_inc	false
shipping_price_supplement_vat_inc	false
feature_1	false
Color	false
special_price_type	false
Sample_SKU	false
Style	false
Unit_count	false
Unit_count_type	false